"filename", "language", "Markdown", "C++", "comment", "blank", "total"
"c:\Users\zhwf\Documents\GitHub\DataSturcture-Homework\Lab10\T1.cpp", "C++", 0, 211, 0, 19, 230
"c:\Users\zhwf\Documents\GitHub\DataSturcture-Homework\Lab10\T2.cpp", "C++", 0, 234, 0, 13, 247
"c:\Users\zhwf\Documents\GitHub\DataSturcture-Homework\Lab11\SYSU_Info.cpp", "C++", 0, 357, 0, 25, 382
"c:\Users\zhwf\Documents\GitHub\DataSturcture-Homework\Lab1\T1.cpp", "C++", 0, 31, 0, 2, 33
"c:\Users\zhwf\Documents\GitHub\DataSturcture-Homework\Lab1\T2 .cpp", "C++", 0, 118, 0, 21, 139
"c:\Users\zhwf\Documents\GitHub\DataSturcture-Homework\Lab1\T3.cpp", "C++", 0, 23, 0, 3, 26
"c:\Users\zhwf\Documents\GitHub\DataSturcture-Homework\Lab2\t1.cpp", "C++", 0, 173, 1, 18, 192
"c:\Users\zhwf\Documents\GitHub\DataSturcture-Homework\Lab2\t2.cpp", "C++", 0, 270, 0, 22, 292
"c:\Users\zhwf\Documents\GitHub\DataSturcture-Homework\Lab2\t3.cpp", "C++", 0, 347, 0, 28, 375
"c:\Users\zhwf\Documents\GitHub\DataSturcture-Homework\Lab2\t4.cpp", "C++", 0, 139, 0, 16, 155
"c:\Users\zhwf\Documents\GitHub\DataSturcture-Homework\Lab2\t5.cpp", "C++", 0, 269, 0, 22, 291
"c:\Users\zhwf\Documents\GitHub\DataSturcture-Homework\Lab3\t1.cpp", "C++", 0, 132, 0, 19, 151
"c:\Users\zhwf\Documents\GitHub\DataSturcture-Homework\Lab3\t2.cpp", "C++", 0, 146, 0, 19, 165
"c:\Users\zhwf\Documents\GitHub\DataSturcture-Homework\Lab3\t3.cpp", "C++", 0, 118, 0, 12, 130
"c:\Users\zhwf\Documents\GitHub\DataSturcture-Homework\Lab3\t4.cpp", "C++", 0, 177, 1, 13, 191
"c:\Users\zhwf\Documents\GitHub\DataSturcture-Homework\Lab4\t1.cpp", "C++", 0, 66, 0, 6, 72
"c:\Users\zhwf\Documents\GitHub\DataSturcture-Homework\Lab4\t2.cpp", "C++", 0, 108, 0, 8, 116
"c:\Users\zhwf\Documents\GitHub\DataSturcture-Homework\Lab4\t3.cpp", "C++", 0, 76, 0, 5, 81
"c:\Users\zhwf\Documents\GitHub\DataSturcture-Homework\Lab4\t4.cpp", "C++", 0, 182, 0, 20, 202
"c:\Users\zhwf\Documents\GitHub\DataSturcture-Homework\Lab4\t5.cpp", "C++", 0, 93, 0, 5, 98
"c:\Users\zhwf\Documents\GitHub\DataSturcture-Homework\Lab5\T1&T2.cpp", "C++", 0, 327, 0, 37, 364
"c:\Users\zhwf\Documents\GitHub\DataSturcture-Homework\Lab5\t3.cpp", "C++", 0, 365, 0, 22, 387
"c:\Users\zhwf\Documents\GitHub\DataSturcture-Homework\Lab5\t4.cpp", "C++", 0, 111, 0, 11, 122
"c:\Users\zhwf\Documents\GitHub\DataSturcture-Homework\Lab6\T1.cpp", "C++", 0, 130, 0, 11, 141
"c:\Users\zhwf\Documents\GitHub\DataSturcture-Homework\Lab6\T2.cpp", "C++", 0, 259, 0, 16, 275
"c:\Users\zhwf\Documents\GitHub\DataSturcture-Homework\Lab7\T1.cpp", "C++", 0, 149, 0, 7, 156
"c:\Users\zhwf\Documents\GitHub\DataSturcture-Homework\Lab7\T2.cpp", "C++", 0, 186, 0, 15, 201
"c:\Users\zhwf\Documents\GitHub\DataSturcture-Homework\Lab8\T1.cpp", "C++", 0, 207, 0, 11, 218
"c:\Users\zhwf\Documents\GitHub\DataSturcture-Homework\Lab8\T2.cpp", "C++", 0, 115, 0, 13, 128
"c:\Users\zhwf\Documents\GitHub\DataSturcture-Homework\Lab8\T3.cpp", "C++", 0, 161, 0, 12, 173
"c:\Users\zhwf\Documents\GitHub\DataSturcture-Homework\Lab9\T1.cpp", "C++", 0, 142, 0, 15, 157
"c:\Users\zhwf\Documents\GitHub\DataSturcture-Homework\Lab9\T2.cpp", "C++", 0, 106, 0, 12, 118
"c:\Users\zhwf\Documents\GitHub\DataSturcture-Homework\Lab9\T3.cpp", "C++", 0, 188, 0, 17, 205
"c:\Users\zhwf\Documents\GitHub\DataSturcture-Homework\README.md", "Markdown", 5, 0, 0, 4, 9
"Total", "-", 5, 5716, 2, 499, 6222